R   900   700
NO   ./texture/north.xpm
SO ./texture/south.xpm
WE          ./texture/west.xpm
EA ./texture/east.xpm
S  ./texture/sprite.xpm

F 169,    169   , 169
C      205, 249    , 255


        1111111111111111111111111
        1000000000112000000000001
        10110000011120000020000011111111
        10012000000000000000000000000001
1111111110101000011100000000000011111101
1200000000000000011100002000111111  1101
11110111111100011100000000001        101
11110011111100011101000000001      11101
11000002112100011100000000001      10001
12002000000000021100000200021      10201
1200000200000000110101000W001      11111
11000001110101011111010000001
11112111 1110121 121111010001
11111111 1111111 111111111111
